WWWWWWWWWWWWWWWWWWWW
WPPPPPPPPPPPPPPPPPWW
WPWWWWWWWWWWWWWWWPWW
WPWPPPQQPPPWWPPPWPGW
WPWPPWWWWPPWWPPWWPWW
WPWPPWPPPPEEPPPWWPWW
WPWWWWWWWWWWWWWWWPWW
WPWPPPPPPPPPPPPPWPWW
WgWPPWWWWWWWWPPPWWWW
WWWWWWWWWWWWWWWWWWWW